61

1 21 -1 -320  400 5952 32 4
31 21 -1 1376 273 96 32 4
32 21 -1 1505 208 320 32 4
33 21 -1 1855 272 192 32 4
34 21 -1 2785 208 544 32 4
35 21 -1 3330 273 128 32 4
36 21 -1 3057 238 32 160 4
37 21 -1 3057 80 32 32 4
38 21 -1 3585 237 32 96 4
39 21 -1 3618 237 96 160 4
40 21 -1 3585 336 32 32 6
41 21 -1 3585 368 32 32 5
42 21 -1 2912 625 608 32 4
43 21 -1 3265 561 64 32 4
44 21 -1 3584 623 64 32 4
45 21 -1 3713 624 288 32 4
46 21 -1 4079 464 16 224 4
47 21 -1 4032 689 64 32 4
48 21 -1 3967 752 64 32 4
49 21 -1 4001 624 32 32 2
50 21 -1 3713 237 64 32 4
51 21 -1 2015 272 32 32 2
52 21 -1 3903 206 416 32 4
53 21 -1 4030 80 64 32 4
54 21 -1 4078 239 16 160 4
55 21 -1 4350 272 352 32 4
56 21 -1 5537 272 96 32 4
57 21 -1 5616 80 16 96 4
58 21 -1 5616 303 16 96 4
59 21 -1 5440 337 32 32 4
60 21 -1 5472 337 32 32 2


2 43 -1 55 338 0 0 0
3 43 -1 180 273 0 0 0
4 43 -1 310 338 0 0 0
5 43 -1 440 273 0 0 0
6 43 -1 565 338 0 0 0
7 43 -1 700 273 0 0 0
8 43 -1 820 338 0 0 0
9 43 -1 950 273 0 0 0
10 43 -1 1080 338 0 0 0
11 43 -1 1205 273 0 0 0
12 43 -1 1335 148 0 0 0
13 43 -1 1715 148 0 0 0
14 43 -1 1850 338 0 0 0
15 43 -1 1975 148 0 0 0
16 43 -1 2100 338 0 0 0
17 43 -1 2230 338 0 0 0
18 43 -1 2355 338 0 0 0
19 43 -1 2480 338 0 0 0
20 43 -1 2605 338 0 0 0
21 43 -1 2735 268 0 0 0
22 43 -1 2870 148 0 0 0 
23 43 -1 3005 88 0 0 0
24 43 -1 3245 148 0 0 0
25 43 -1 3375 118 0 0 0
26 43 -1 3125 343 0 0 0
27 43 -1 3505 278 0 0 0

28 26 -1 3054 113 0 0 0
29 26 -1 4076 112 0 0 0
30 26 -1 5600 178 0 0 0


//[id] [objectType] [x] [y] [w] [h] [model]
//objectType: 21: Brick
//	      43: Candle 
//            26: Gate