114

1 21 -1 -320  400 5952 32 4
31 21 -1 1376 273 96 32 4
32 21 -1 1505 208 320 32 4
33 21 -1 1855 272 192 32 4
34 21 -1 2785 208 544 32 4
35 21 -1 3330 273 128 32 4
36 21 -1 3057 238 32 160 4
37 21 -1 3057 80 32 32 4
38 21 -1 3585 237 32 96 4
39 21 -1 3618 237 96 160 4
40 21 -1 3585 336 32 32 6
41 21 -1 3585 368 32 32 5
42 21 -1 2912 625 608 32 4
43 21 -1 3265 561 64 32 4
44 21 -1 3584 623 64 32 4
45 21 -1 3713 624 288 32 4
46 21 -1 4079 464 16 224 4
47 21 -1 4032 689 64 32 4
48 21 -1 3967 752 64 32 4
49 21 -1 4001 624 32 32 2
50 21 -1 3713 237 64 32 4
51 21 -1 2015 272 32 32 2
52 21 -1 3903 206 416 32 4
53 21 -1 4030 80 64 32 4
54 21 -1 4078 239 16 160 4
55 21 -1 4350 272 352 32 4
56 21 -1 5537 272 96 32 4
57 21 -1 5616 80 16 96 4
58 21 -1 5616 303 16 96 4
59 21 -1 5440 337 32 32 4
60 21 -1 5472 337 32 32 2
81 21 -1 3776 271 128 32 4

2  43 -1 55 338 0 0 0
3  43 -1 180 273 0 0 0
4  43 -1 310 338 0 0 0
5  43 -1 440 273 0 0 0
6  43 -1 565 338 0 0 0
7  43 -1 700 273 0 0 0
8  43 -1 820 338 0 0 0
9  43 -1 950 273 0 0 0
10 43 -1 1080 338 0 0 0
11 43 -1 1205 273 0 0 0
12 43 -1 1335 148 0 0 0
13 43 -1 1715 148 0 0 0
14 43 -1 1850 338 0 0 0
15 43 -1 1975 148 0 0 0
16 43 -1 2100 338 0 0 0
17 43 -1 2230 338 0 0 0
18 43 -1 2355 338 0 0 0
19 43 -1 2480 338 0 0 0
20 43 -1 2605 338 0 0 0
21 43 -1 2735 268 0 0 0
22 43 -1 2870 148 0 0 0 
23 43 -1 3005 88  0 0 0
24 43 -1 3245 148 0 0 0
25 43 -1 3375 118 0 0 0
26 43 -1 3125 343 0 0 0
27 43 -1 3505 278 0 0 0
90 43 -1 3121 498 0 0 0
91 43 -1 3254 498 0 0 0
92 43 -1 3382 498 0 0 0
93 43 -1 3505 498 0 0 0
94 43 -1 3636 498 0 0 0
95 43 -1 3760 498 0 0 0
96 43 -1 3881 498 0 0 0
97 43 -1 4017 498 0 0 0
98 43 -1 3762 332 0 0 0
99 43 -1 3672 107 0 0 0
100 43 -1 3889 88 0 0 0
101 43 -1 4019 145 0 0 0
102 43 -1 4274 150 0 0 0
103 43 -1 4404 208 0 0 0
104 43 -1 4141 277 0 0 0
105 43 -1 4530 150 0 0 0
106 43 -1 4668 338 0 0 0
107 43 -1 4796 273 0 0 0
108 43 -1 4920 338 0 0 0
109 43 -1 5045 338 0 0 0
110 43 -1 5169 273 0 0 0
111 43 -1 5296 338 0 0 0
112 43 -1 5424 273 0 0 0
113 43 -1 5557 273 0 0 0

28 26 -1 3056 113 0 0 0
29 26 -1 4076 112 0 0 0
30 26 -1 5610 178 0 0 0

61 47  1 1248 397 0 0 0
62 48  1 1377 212 0 0 0
63 47  1 2594 397 0 0 0
64 48  1 2786 148 0 0 0
65 47 -1 3542 395 0 0 0
66 48 -1 3413 210 0 0 0
67 47  1 1441 272 0 0 0
68 48  1 1506 147 0 0 0
69 47 -1 1880 271 0 0 0
70 48 -1 1815 149 0 0 0
71 47 -1 3960 623 0 0 0
72 48 -1 3797 338 0 0 0
73 47 -1 3992 398 0 0 0
74 48 -1 3866 216 0 0 0
75 47 -1 3255 557 0 0 0
76 48 -1 3158 345 0 0 0
84 47 -1 4378 275 0 0 0
85 48 -1 4310 149 0 0 0
86 47 -1 4825 398 0 0 0
87 48 -1 4693 215 0 0 0
88 47  1 5472 330 0 0 0
89 48  1 5540 216 0 0 0

77 42 -1 3190 431 40 10 0
82 42 -1 3180 108 100 100 0
83 42 -1 4195 110 100 100 0
114 42 -1 5404 318 100 100 0
//[id] [objectType] [x] [y] [w] [h] [model]
//objectType: 21: Brick
//	      43: Candle 
//            26: Gate
//	      47: StairBottom
//            48: StairTop
//            42:objectHiden 